A Few Clouds=Quelques nuages
A Few Clouds and Breezy=Quelques nuages et Frais
A Few Clouds and Windy=Quelques nuages et grand vent
A Few Clouds with Haze=Quelques nuages et brume
AM Clouds / PM Sun=Nuages le matin / Soleil l'Après-Midi
AM Fog / PM Sun=Brouillard le matin / Soleil l'Après-Midi
AM Rain / Snow Showers=Pluie le matin / averses neigeuses
AM Showers=Averses matinales
AM Snow Showers=Averses de neige le matin
AM T-Storms=Orages le matin
Blowing Dust=Vent de poussière
Blowing Sand=Vent de sable
Blowing Snow=Vent de neige
Blowing Snow in Vicinity=Vent de neige dans les environs
Clear=Clair
Clear / Wind=Clair / vent
Clear and Breezy=Clair et frais
Clear with Haze=Clair avec brume légère
Cloudy Clair=Nuageux clair
Clouds Early / Clearing Late=Nuages matinaux suivis d'éclaircies
Cloudy=Nuageux
Cloudy / Wind=Nuageux / Vent
Cloudy / Windy=Nuageux / Vent
Drifting Snow=Amoncellement de neige
Drizzle=Crachin
Drizzle Fog/Mist=Crachin brouillard/brume
Drizzle Fog=Crachin brouillard
Drizzle Ice Pellets=Crachin grêlons
Drizzle Snow=Crachin neige
Dust=Poussière
Dust Storm in Vicinity=Tempête de poussière dans les environs
Dust Storm=Tempête de poussière
Dust/Sand Whirls=Tourbillons de poussière/sable
Dust/Sand Whirls in Vicinity=Tourbillons de poussière/sable dans les environs
Fair=Ciel dégagé
Fair/ Windy=Ciel dégagé / grand vent
Fair and Breezy=Ciel dégagé et frais
Fair and Windy=Ciel dégagé et grand vent
Fair with Haze=Ciel dégagé avec brume légère
Few Showers=Quelques averses
Few Snow Showers=Quelques averses de neige
Few Snow Showers / Wind=Quelques averses de neige / Vent
Fog=Brouillard
Fog in Vicinity=Brouillard dans les environs
Fog/Mist=Brouillard/brume
Freezing Drizzle=Crachin givrant
Freezing Drizzle in Vicinity=Crachin givrant dans les environs
Freezing Drizzle Rain=Crachin pluie givrant
Freezing Drizzle Snow=Crachin neige givrant
Freezing Fog=Brouillard givrant
Freezing Fog in Vicinity=Brouillard givrant dans les environs
Freezing Rain=Pluie givrante
Freezing Rain in Vicinity=Pluie givrante dans les environs
Freezing Rain Snow=Pluie neige givrante dans les environs
Frigid=Grand froid
Funnel Cloud in Vicinity=Nuage en entonnoir dans les environs
Funnel Cloud=Nuage en entonnoir
Hail=Grêle
Hail Showers=Averses de grêle
Haze=Brume légère
Heavy Drizzle=Gros Crachin
Heavy Drizzle Fog/Mist=Gros Crachin Brouillard/brume
Heavy Drizzle Fog=Gros Crachin Brouillard
Heavy Drizzle Ice Pellets=Gros Crachin Grêlons
Heavy Drizzle Snow=Gros Crachin Neige
Heavy Dust Storm=Grosse tempête de poussière
Heavy Freezing Drizzle Rain=Gros Crachin verglassant Pluie
Heavy Freezing Drizzle Snow=Gros Crachin verglassant Neige
Heavy Freezing Drizzle=Gros Crachin verglassant
Heavy Freezing Fog=Gros brouillard verglassant
Heavy Freezing Rain Snow=Grosse pluie verglassante Neige
Heavy Freezing Rain=Grosse pluie verglassante
Heavy Ice Pellets=Gros Grêlons
Heavy Ice Pellets Drizzle=Gros Grêlons Crachin
Heavy Ice Pellets Rain=Gros Grêlons Pluie
Heavy Rain=Grosse pluie
Heavy Rain Fog/Mist=Grosse pluie Brouillard/brume
Heavy Rain Fog=Grosse pluie Brouillard
Heavy Rain Freezing Drizzle=Grosse pluie Crachin verglassant
Heavy Rain Freezing Rain=Grosse pluie Pluie verglassante
Heavy Rain Ice Pellets=Grosse pluie Grêlons
Heavy Rain Icy=Grosse pluie verglassante
Heavy Rain Showers Fog/Mist=Grosse pluie Averses Brouillard/brume
Heavy Rain Showers=Grosse pluie Averses
Heavy Rain Snow=Grosse pluie Neige
Heavy Sand Storm=Grosse tempête de sable
Heavy Showers Rain Fog/Mist=Grosses averses Pluie Brouillard/brume
Heavy Showers Rain=Grosses averses Pluie
Heavy Showers Snow Fog/Mist=Grosses Neige Pluie Brouillard/brume
Heavy Showers Snow Fog=Grosses averses Neige Brouillard
Heavy Showers Snow=Grosses averses Neige
Heavy Snow=Beaucoup de neige
Heavy Snow Drizzle=Beaucoup de neige Crachin
Heavy Snow Fog/Mist=Beaucoup de neige Brouillard/brume
Heavy Snow Fog=Beaucoup de neige Brouillard
Heavy Snow Freezing Drizzle=Beaucoup de neige Crachin verglassant
Heavy Snow Freezing Rain=Beaucoup de neige Pluie verglassante
Heavy Snow Rain=Beaucoup de neige Pluie
Heavy Snow Showers Fog/Mist=Beaucoup de neige Averses Brouillard/brume
Heavy Snow Showers Fog=Beaucoup de neige Averses Brouillard
Heavy Snow Showers=Beaucoup de neige Averses
Heavy T-Storm=Gros orage
Heavy T-Storms Rain Fog/Mist=Gros orage Brouillard/brume
Heavy T-Storms Rain Fog=Gros orage Brouillard
Heavy T-Storms Rain Hail Fog/Mist=Gros orage Grêle Brouillard/brume
Heavy T-Storms Rain Hail Fog=Gros orage Grêle  Brouillard
Heavy T-Storms Rain Hail Haze=Gros orage Grêle Brume légère
Heavy T-Storms Rain Hail=Gros orage Grêle
Heavy T-Storms Rain Haze=Gros orage Brume légère
Heavy T-Storms Rain=Gros orage Pluie
Heavy T-Storms Snow=Gros orage Neige
Ice Crystals=Cristaux de glace
Ice Pellets Drizzle=Grêlons Crachin
Ice Pellets in Vicinity=Grêlons dans les environs
Ice Pellets Rain=Grêlons Pluie
Ice Pellets=Grêlons
Isolated T-Storms=Orages isolés
Light Drizzle=Léger crachin
Light Drizzle Fog/Mist=Léger crachin Brouillard/brume
Light Drizzle Fog=Léger crachin Brouillard
Light Drizzle Ice Pellets=Léger crachin Grêlons
Light Drizzle Snow=Léger crachin Neige
Light Freezing Drizzle=Léger crachin verglassant
Light Freezing Drizzle Rain=Léger crachin verglassant Pluie
Light Freezing Drizzle Snow=Léger crachin verglassant Neige
Light Freezing Fog=Léger brouillard verglassant
Light Freezing Rain=Légère pluie verglassante
Light Freezing Rain Snow=Légère pluie verglassante Neige
Light Ice Pellets Drizzle=Petit Grêlons Crachin
Light Ice Pellets Rain=Petit Grêlons Pluie
Light Ice Pellets=Petit Grêlons
Light Rain=Légère Pluie
AM Light Rain=Légère Pluie
Light Rain Early=Légère Pluie matinal
Light Rain Fog/Mist=Légère Pluie Brouillard/brume
Light Rain Fog=Légère Pluie Brouillard
Light Rain Freezing Drizzle=Légère Pluie Crachin verglassant
Light Rain Freezing Rain=Légère Pluie Pluie verglassante
Light Rain Ice Pellets=Légère Pluie Grêlons
Light Rain Icy=Légère pluie verglassante
Light Rain Late=Légère Pluie tardive
Light Rain Shower=Légère pluie Averse
Light Rain Shower and Windy=Légère pluie Averses et Vent
Light Rain Showers=Légères pluie Averses
Light Rain Snow=Légères pluie Neige
Light Rain with Thunder=Légère Pluie avec tonnerre
Light Showers Rain=Légère averses Pluie
Light Showers Rain Fog/Mist=Légère averses Pluie Brouillard/brume
Light Showers Snow=Légère averses Neige
Light Showers Snow Fog=Légère averses Neige Brouillard
Light Showers Snow Fog/Mist=Légère averses Neige Brouillard/brume
Light Snow=Peu de neige
Light Snow Drizzle=Peu de neige Crachin
Light Snow Fall=Légère chutes de neige
Light Snow Fog/Mist=Peu de neige Brouillard/brume
Light Snow Fog=Peu de neige Brouillard
Light Snow Freezing Drizzle=Peu de neige Crachin verglassant
Light Snow Freezing Rain=Peu de neige Pluie Verglassante
Light Snow Grains=Quelques flocons de neige
Light Snow Rain=Peu de neige Pluie
Light Snow Shower=Légère averse de neige
Light Snow Showers Fog/Mist=Légère averses de neige Brouillard/brume
Light Snow Showers Fog=Légère averses de neige Brouillard
Light T-Storms Rain Fog/Mist=Léger orages Pluie Brouillard/brume
Light T-Storms Rain Fog=Léger orages Pluie Brouillard
Light T-Storms Rain Hail Fog/Mist=Léger orages Pluie Grêle Brouillard/brume
Light T-Storms Rain Hail Fog=Léger orages Pluie Grêle Brouillard
Light T-Storms Rain Hail Haze=Léger orages Pluie Grêle Brume légère
Light T-Storms Rain Hail=Léger orages Pluie Grêle
Light T-Storms Rain Haze=Léger orages Pluie Brume légère
Light T-Storms Rain=Léger orages Pluie
Light T-Storms Snow=Léger orages Neige
Lightening=Eclairs
Lightenings=Eclairs
Mostly Clear=Ciel plutôt dégagé
Mostly Cloudy=Plutôt nuageux
Mostly Cloudy and Breezy=Plutôt nuageux et Venteux
Mostly Cloudy and Windy=Plutôt nuageux et Grand vent
Mostly Cloudy with Haze=Plutôt nuageux avec Légère Brume
Mostly Sunny=Plutôt ensoleillé
Mostly Sunny / Wind=Plutôt ensoleillé / vent
Overcast=Couvert
Overcast and Breezy=Couvert et Venteux
Overcast and Windy=Couvert et Grand vent
Overcast with Haze=Couvert avec légère brume
Partial Fog=Banc de Brouillard
Partial Fog in Vicinity=Banc de Brouillard dans les environs
P Cloudy=Partiellement nuageux
Partly Cloudy=Partiellement nuageux
Partly Cloudy and Breezy=Partiellement nuageux et Venteux
Partly Cloudy and Windy=Partiellement nuageux et Grand vent
Partly Cloudy / Wind=Partiellement nuageux / Vent
Partly Cloudy/ Windy=Partiellement nuageux / Venteux
Party Cloudy with Haze=Partiellement nuageux avec légère brume
Partly Sunny=Partiellement ensoleillé
Patches of Fog=Nappes de Brouillard
Patches of Fog in Vicinity=Nappes de Brouillard dans les environs
PM light rain=Légère Pluie l'après-nmidi
PM Rain / Snow=Pluie / Neige l'après-nmidi
PM Rain / Wind=Pluie / Vent l'après-nmidi
PM Showers=Averses l'après-nmidi
PM Snow Showers=averses neigeuses l'après-nmidi
PM T-Storms=Orages l'après-midi
Rain=Pluie
Rain / Snow=Pluie / neige
Rain / Snow Showers=Pluie / averses neigeuses
Rain / Snow Showers Early=Pluie / averses neigeuses matinales
Rain / Thunder=Pluie / Tonnerre
Rain / Wind=Pluie / Vent
Rain and Snow=Pluie et Neige
Rain Early=Pluie matinale
Rain Fog/Mist=Pluie Brouillard/brume
Rain Fog=Pluie Brouillard
Rain Freezing Drizzle=Pluie Crachin verglassant
Rain Freezing Rain=Pluie Pluie Verglassante
Rain Ice Pellets=Pluie Grêlons
Rain Shower=Pluie Averses
Rain Showers Fog/Mist=Pluie Averses Brouillard/brume
Rain Showers in Vicinity Fog/Mist=Pluie Averses dans les environs Brouillard/brume
Rain Showers in Vicinity=Pluie Averses dans les environs
Rain Snow=Pluie Neige
Rain to Snow=Pluie se transformant en Neige
Sand Storm=Tempête de Sable
Sand Storm in Vicinity=Tempête de Sable dans les environs
Sand=Sable
Shallow Fog=Brouillard superficiel
Shallow Fog in Vicinity=Brouillard superficiel dans les environs
Scattered Showers=Averses éparses
Scattered Showers / Wind=Averses éparses / Vent
Scattered Snow Showers=Averses neigeuses éparses
Scattered Snow Showers / Wind=Averses neigeuses éparses / Vent
Scattered Strong Storms=Violents orages locals
Scattered T-Storms=Orages éparses
Showers=Averses
Showers / Wind=Averses / Vent
Showers Hail=Averses Grêle
Showers Ice Pellets=Averses Grêlons
Showers in the Vicinity=Averses dans les environs
Showers in Vicinity Fog/Mist=Averses dans les environs Brouillard/brume
Showers in Vicinity Fog=Averses dans les environs Brouillard
Showers in Vicinity Haze=Averses dans les environs Brume légère
Showers in Vicinity Snow=Averses dans les environs Neige
Showers Early=Averses matinales
Showers Late=Averses tardives
Showers Rain=Averses Pluie
Showers Rain Fog/Mist=Averses Pluie Brouillard/brume
Showers Rain in Vicinity=Averses Pluie dans les environs
Showers Rain in Vicinity Fog/Mist=Averses Pluie dans les environs Brouillard/brume
Showers Snow=Averses Neige
Showers Snow Fog=Averses Neige Brouillard
Showers Snow Fog/Mist=Averses Neige Brouillard/brume
Smoke=fumée
Snow=Neige
Snow / Rain Icy Mix=Mélange Neige / Pluie Verglassante
Snow and Fog=Neige et Brouillard
Snow Drizzle=Neige Crachin
Snow Fog/Mist=Neige Brouillard/brume
Snow Freezing Drizzle=Neige Crachin verglassant
Snow Freezing Rain=Neige Pluie verglassante
Snow Rain=Neige Pluie
Snow Shower=Averses de neige
Snow Shower / Wind=Averses de neige / vent
Snow Shower Early=Averses de neige matinales
Snow Showers Fog/Mist=Averses de neige Brouillard/brume
Snow Showers Fog=Averses de neige Brouillard
Snow Showers in Vicinity=Averses de neige dans les environs
Snow Showers in Vicinity Fog=Averses de neige dans les environs Brouillard
Snow Showers in Vicinity Fog/Mist=Averses de neige dans les environs Brouillard/brume
Snow Showers Late=Averses de neige tardives
Snow to Rain=Neige vers Pluie
Snowflakes=Flocons de neige
Sunny=Ensoleillé
Sunny / Wind=Ensoleillé / Vent
Sunny Day=Journée ensoleillé
Thunder=Tonnerre
Thunder in the Vicinity=Tonnerre dans les environs
T-Storms=Orages
T-Storms Early=Orages matinaux
T-Storms Fog=Orages Brouillard
T-Storms Hail Fog=Orages Grêle Brouillard
T-Storms Hail=Orages Grêle
T-Storms Haze in Vicinity Hail=Orages brume dans les environs Grêle
T-Storms Haze in Vicinity=Orages brume dans les environs
T-Storms Heavy Rain=Orages Grosse Pluie
T-Storms Heavy Rain Fog=Orages Grosse Pluie Brouillard
T-Storms Heavy Rain Fog/Mist=Orages Grosse pluie Brouillard/brume
T-Storms Heavy Rain Hail Fog=Orages Grosse Pluie Grêle Brouillard
T-Storms Heavy Rain Hail Fog/Mist=Orages Grosse Pluie Grêle Brouillard/brume
T-Storms Heavy Rain Hail Haze=Orages Grosse Pluie Grêle Brume légère
T-Storms Heavy Rain Hail=Orages Grosse Pluie Grêle
T-Storms Heavy Rain Haze=Orages Grosse Pluie Brume légère
T-Storms Ice Pellets=Orages Grêlons
T-Storms in Vicinity=Orages dans les environs
T-Storms in Vicinity Fog=Orages dans les environs Brouillard
T-Storms in Vicinity Fog/Mist=Orages dans les environs Brouillard/brume
T-Storms in Vicinity Hail Fog/Mist=Orages dans les environs Grêle Brouillard/brume
T-Storms in Vicinity Hail Haze=Orages dans les environs Grêle Brume légère
T-Storms in Vicinity Hail=Orages dans les environs Grêle
T-Storms in Vicinity Haze=Orages dans les environs Brume légère
T-Storms Light Rain=Orages Légère pluie
T-Storms Light Rain Fog=Orages Légère pluie Brouillard
T-Storms Light Rain Fog/Mist=Orages Légère pluie Brouillard/brume
T-Storms Light Rain Hail=Orages Légère pluie Grêle
T-Storms Light Rain Hail Fog=Orages Légère pluie Grêle Brouillard
T-Storms Light Rain Hail Fog/Mist=Orages Légère pluie Grêle Brouillard/brume
T-Storms Light Rain Hail Haze=Orages Légère pluie Grêle Brume légère
T-Storms Light Rain Haze=Orages Légère pluie Brume légère
T-Storms Rain Fog/Mist=Orages Pluie Brouillard/brume
T-Storms Rain Hail Fog/Mist=Orages Pluie Grêle Brouillard/brume
T-Storms Showers in Vicinity=Orages Averses dans les environs
T-Storms Showers in Vicinity Hail=Orages Averses dans les environs Grêle
T-Storms Snow=Orages Neige
Windy=Grand vent
Windy / Snowy=Grand vent / neigeux
Windy Rain=giboulées
Wintry Mix=Mélanges pluie/neige
Wintry Mix / Wind=Mélanges pluie/neige / vent